NO ./img/wall1.xpm
SO ./img/wall2.xpm
WE ./img/wall3.xpm
EA ./img/wall4.xpm

F 98,255,33
C 10,255,240

11111111111111111111111111111111111111111111111111111111111111111111111111111111111111111111111111111111111111111111
10000000000000001000000000000000000000000000000000000000000000000000000000000000000000000000000000000000000000000011
11111111111111001000000000000000000000000000000000000000000000000000000000000000000000000000000000000000000000000001
10000000000000000000000000000000000000000000000000000000000000000000000000000000000000000000000000000000000000000001
10000000000000111111111100000000000000000000000000000000000000000000000000000000000000000000000000000000000000000001
10000000000000111000000000000000000000000000000000000000000000000000000000000000000000000000000000000000000000000001
11100000000000111000000000000000000000000000000000000000000000000000000000100000000000000000000000000000000000000001
10000000000000000000000000000000000000000000000000000000000000000000000000100000000000000000000000000000000000000001
10000000000000000000000000000000000000000000000000000000000000000000000000100000000000000000000000000000000000000001
10000000000000000000000000000000000000000000000000000000000000000000000000100000000000000000000000000000000000000001
10000000000000000000000000000000000000000000000000000000000000000000000000100000000000000000000000000000000000000001
10000000000000000000000000000000000000000000000000000000000000000000000000100000000000000000000000000000000000000001
10000000000000000000000000000000000000000000000000000000011000000000000000100000000000000000000000000000000000000001
10001111111111111111111111000000000000000000000000000000011000000000000000100000000000000000000000000000000000000001
10000000000000000000000000000000000000000000000000000000011000000000000000100000000000000000000000000000000000000001
10000000000000000000000000000000000000000000000000000000011000000000000000100000000000000000000000000000000000000001
10000000000000000000000000000000000000000000000000000000011000000000000000100000000000000000000000000000000000000001
10000000000000001000000000000000000000000000000000000000000000000000000000000000000000000000000000000000000000000011
11111111111111001000000000000000000000000000000000000000000000000000000000000000000000000000000000000000000000000001
10000000000000000000000000000000000000000000000000000000000000000000000000000000000000000000000000000000000000000001
10000000000000111111111100000000000000000000000000000000000000000000000000000000000000000000000000000000000000000001
10000000000000111000000000000000000000000000000000000000000000000000000000000000000000000000000000000000000000000001
11100000000000111000000000000000000000000000000000000000000000000000000000100000000000000000000000000000000000000001
10000000000000000000000000000000000000000000000000000000000000000000000000100000000000000000000000000000000000000001
10000000000000000000000000000000000000000000000000000000000000000000000000100000000000000000000000000000000000000001
1000000000000000000000000S000000000000000000000000000000000000000000000000100000000000000000000000000000000000000001
10000000000000000000000000000000000000000000000000000000000000000000000000100000000000000000000000000000000000000001
10000000000000000000000000000000000000000000000000000000000000000000000000100000000000000000000000000000000000000001
10000000000000000000000000000000000000000000000000000000011000000000000000100000000000000000000000000000000000000001
10001111111111111111111111000000000000000000000000000000011000000000000000100000000000000000000000000000000000000001
10000000000000000000000000000000000000000000000000000000011000000000000000100000000000000000000000000000000000000001
10000000000000000000000000000000000000000000000000000000011000000000000000100000000000000000000000000000000000000001
11111111111111111111111111111111111111111111111111111111111111111111111111111111111111111111111111111111111111111111
