F 220,100,0
C 225,30,0
NO ./img/wall1.xpm
SO ./img/wall2.xpm
WE ./img/wall3.xpm
EA ./img/wall4.xpm



       11111111111111111111111111
       11000000001100000000000001
       11110000011100000000000001
       11100100000000000000000001
111111111011000001110000000000001
100000000011000001110111111111111
11110111111111011100000010001
11110111111111011101010010001
11000000110101011100000010001
10000000000000011100000010001
10000000000000011101010010001
11000001110101011111011110N0111
11110111 1110101 101111010001
11111111 1111111 111111111111